1111111111111
1001000000001
1000010000001
1PPC010000001
1111111111111
