1111111111111
1001CC00000C1
1000C11111001
1P0011E000011
1111111110111
